__#####___#####__
___##_##_##_##___
_######___######_
___##_#####_##___
__#####_#_#####__
___##_##_##_##___
__#####___#####__
__###_##_##_###__
#################
#################