#################
#################
_######___######_
___##_#####_##___
#################
#################
__#####___#####__
__###_##_##_###__
#################
#################