##################
#_________________
#_###############_
#_#_____________#_
#_#_###########_#_
#_#___________#_#_
#_#############_#_
#_______________#_
#################_