_____________
_###_____###_
#___#___#____
#___#___#____
#________###_
#_###_______#
#___#_______#
_###_____###_