#################
___##_##_##_##___
_######___######_
#__##_#####_##__#
__#####_#_#####__
#__##_##_##_##__#
#_#####_#_#####_#
#_###_##_##_###_#
#################
#################