##____#####____##
#___#########___#
___##_______##___
___#_________#___
___#____#____#___
___#_________#___
___##_______##___
#___#########___#
##____#####____##